11111111111111111111111111111111111111111
10110000110000000000000000000000000000001
10011001000000000000000000000000000000001
11010000000000000000000000000000000000001
10010000000000000000000000000000000000001
10110000000000000000000000000000000000001
10010000000000000000000000000000000011111
11010000000000000000000000000000000010001
10010000000000000000000000000000000010001
10111111111111111100000000000000000010001
10000000000000000100000000000000000000001
11111111111111101111110111111111111111011
10000000000000100000000000000000001000101
11101111000000111110011111111111000010001
10000001000000000000000000000001001000101
10000001001001001001001001001001000010001
10000001000000000000000000000001001000101
11111101111111111111111111111101111111111
10000000000000000000000000000000000000001
10000000000000000000000000000000000000001
11111111111111111111111111111111111111111
