11111111111111111111111111111111111111111
10000000000000000000000000000000000000001
10000000000000000000000000000000000000001
10000000000000000000000000000000000000001
10000000000000000000000000000000000000001
10000000000000000000000000000000000000001
10000000000000000000000000000000000011111
10000000000000000000000000000000000010001
10000000000000000000000000000000000010001
10000000000000000000000000000000000010001
10000000000000000000000000000000000010001
11111111111111100000000000000000000011011
10000000000000100000000000000000000000001
11101111000000111110011111111111000000001
10000001000000000000000000000001000000001
10000001001001001001001001001001000000001
10000001000000000000000000000001000000001
11111101111111111111111111111101111111111
10001000000000000000000000000000000000001
10000000000000000000000000000000000000001
11111111111111111111111111111111111111111
